################
#.####.........#
#.#....#..#....#
#.##...#..#....#
#.#....#..#....#
#.#.....##.....#
#..............#
#.###..#...#...#
#.#..#..#.#....#
#.#.#....#.....#
#.#..#...#.....#
#.#..#...#.....#
#..............#
#..............#
#..............#
################
